1---------
-------333
4--2-1----
4--2------
4---------
4----3---1
-----3----
-----3----
-22-----2-
-----1--2-