---1---2--
-------2--
-333-----1
----------
----2-----
----2-----
333---4-22
------4---
--1---4-1-
------4---