----1---3-
22------3-
-----22-3-
----------
1-333--1--
----------
----1-----
-2--------
-2--------
----4444-1