-------1--
333-------
------1---
----2-----
3---2-----
3-1----2--
3------2-2
---------2
----4444--
--1-------