----22---1
----------
-------22-
-4--1-----
-4--------
-4---2--1-
-4---2----
---------3
-333-----3
-----1---3