-------22-
--333-----
1---------
-----22---
3--------2
3--------2
3---------
--1--4444-
----------
1-----1---