-------22-
--333-----
1---------
-----22---
--1------2
---------2
--3-------
--3--4444-
--3-------
1-----1---