-----22---
-1--------
----3-4444
----3-----
----3---1-
333-------
------2---
-1----2---
--------1-
-----22---