----------
---22--1--
1--------4
----1----4
---------4
--333----4
----------
2--22---1-
2---------
----333---