-------1--
-----2----
--2--2----
--2-----1-
----------
-22--3----
-----3---4
-----3---4
1------1-4
---333---4