----------
------22--
---------1
--3-------
--3----1-2
--3------2
1----333--
----------
-2-1------
-2----4444