--333--22-
1---------
----4444--
----------
--1----2--
-------2--
-2---1----
-2-----333
----------
-----1----