----4444-1
-2--------
-2--------
----------
----------
1-333--1--
----------
-----22-3-
22------3-
----1---3-