-----1----
2--1---333
2---------
----4-----
-3--4--22-
-3--4-----
-3--4---2-
--------2-
-1--------
-----1----