---1----1-
-3--------
-3--4444--
-3------1-
-----1----
--------2-
-22-----2-
----------
-----333--
22--------