-------22-
--1-------
---------1
--333-----
--------3-
2-1-----3-
2-------3-
----22----
-1--------
------4444