-3-----333
-3--1-----
-3------22
------1---
----------
--4444----
----------
--------22
1--2------
---2--1---