------22--
22--1-----
----------
--------3-
--1-4---3-
----4---3-
1---4-----
----4----2
---------2
-333---1--