-------1--
-1--------
----333---
--2-----1-
1-2-------
-----4444-
----------
---333----
2-------22
2---------