----------
-22--3--4-
-----3--4-
-1---3--4-
--------4-
--2---1---
--2-------
--------22
-333-1----
--------1-