-------22-
22--------
-----4----
3----4--1-
3----4----
3----4-1--
----------
-1----333-
---2------
---2---1--